
















W  WWWWWWWWWWWWW         WWWWWWWWWWWWW    WWWWWWWW        W
W                                                         W
W                    E                           E        W                                                          
W                                                         W
WWWWWWWWW        WWWWWWWWWWWW             WWWWWWWWWWWWWWWWW
W                                                         W
W          C                         E                    W                                                          
W                                E                        W                                                          
W                                                         W
W                                                         W
W         WWWWWWWWWWWWW           WWWWWWWWWWWWWW          W
W                                                         W
W           E                                             W
W                                                         W
W     WWWWWWW             WWWWWWWWW                       W
W  E                                   E                  W
WWWWWWW          WWWWWWW           WWWWWWWWWWWWWWWWW      W       