


















WWWWWWWWWW       WWWWWWWWWWWWWWW            WWWWWWWWWWWWWWW
W      BBBB                                               W
W                                             E           W 
W    WWWWWWWWWWW           C               WWWWWWWWWWWW   W
W                                                         W
W                                    BBBB                 W
W            E                                            W
W     WWWWWWWWWWWWWWWWWWWWWWW                             W
W                                        E                W
W                      BBBB                               W
W                   WWWWWWWWWWWWW   WWWWWWWWWWWWWW        W
W                                                         W 
W                                                         W
W                                                         W
W         E                                               W
W     WWWWWWWWWW                                          W
W                                   E                     W
W        BBB                                              W
W       WWWWWWWWWW               WWWWWWWWWWWWWW           W
W                                                         W
W                                                         W
W                        E                            E   W
WWWWWWWWWW         WWWWWWWWWWWWWWW          WWWWWWWWWWWWWWW
  