


  



  WWWWWWWWWWWWW         WWWWWWWWWWWWW    WWWWWWWW

           A         A

WWWWWWWWW        WWWWWWWWWWWW             WWWWWWWWWWWWWWWW
           C
  
           A            A

         WWWWWWWWWWWWW           WWWWWWWWWWWWWW
                    A


      WWWWWWW      A      WWWWWWWWW 
  
WWWWWWW          WWWWWWW           WWWWWWWWWWWWWWWWW