







WWWWWWWW  WWWW  WWWWWW  WWWW WWW WWWWW WWWWWWWWW
W                                              W
WWWWWWW   WWWWWWWWWWWWWWWWW   WWWWWWWWWWW   WWWW  
W                   E                          W
WWWWWWWWWWWW    WWWWWWWWW    WWWWW   WWWWWW    W
W                                              W
W     E                          E             W
WWWWWWWW     WWWWWWWWWW       WWWWWWWWWWWWWWW  W
W                                              W
W                                              W
W                       B                      W
W                                              W
W                                              W
W                                              W
W                                              W
W            B                      B          W
W                                              W
W                                              W
W                        C                     W
W                                              W
W                                              W
W                                   E          W
W      E                                       W
WWWWWWWWWWWWWWWWWWWWWWWWW   WWWWWWWWWWWWWWWW   W
W                                              W
W   B                        E                 W
W               WWWWWWWWWWWWWWWWWWWWW          W
W                                              W
W         E                  E                 W
WWWWWW WWWWWWWWW          WWWWWWWWWWWWWWW      W
W                                              W
W     E                                        W
W WWWWWWWWWWW  WWWWWWWWWWWWWWWWWW              W
W                                              W
W                                              W
W        WWWWWWWWWWWWWWW         WWWWWWWWWWWW  W
W                           E                  W
W   WWWWWWWW             WWWWWWWWW             W
WWWWWW         WWWWWWWW             WWWWWWWWWWWW