
















W  WWWWWWWWWWWWW         WWWWWWWWWWWWW    WWWWWWWW    WWWWW
W                                                         W
W                    E             E             E        W W                               wwwwwwww                  W
WWWWWWWWW        WWWWWWWWWWWW             WWWWWWWWWWWWWWWWW
W                                                         W
W          C        E                E                    W 
W                WWWWWW          E  WWWWWWWWW             W                                                          
W WWWWWWWWWWWW                WWWWWW                      W
W                E                                        W
W         WWWWWWWWWWWWW           WWWWWWWWWWWWWW          W
W                                                         W
W           E                                             W
W                            E               E            W
W     WWWWWWW             WWWWWWWWW      WWWWWWWWW        W
W  E               E                   E                  W
WWWWWWW          WWWWWWW           WWWWWWWWWWWWWWWWW      W       