------------------BB------------------
//BB//B/////BBBBB///BBBBB/////////////
___PP_____PPP____________PP___________
------------------BB------------------
//BB//B/////BBBBB///BBBBB/////////////
___PP_____PPP____________PP___________
------------------BB------------------
//BB//B/////BBBBB///BBBBB/////////////
___PP_____PPP____________PP___________
------------------BB------------------
//BB//B/////BBBBB///BBBBB/////////////
___PP_____PPP____________PP___________
------------------BB------------------
//BB//B/////BBBBB///BBBBB/////////////
___PP_____PPP____________PP___________
------------------BB------------------
//BB//B/////BBBBB///BBBBB/////////////
___PP_____PPP____________PP___________
------------------BB------------------
//BB//B/////BBBBB///BBBBB/////////////
___PP_____PPP____________PP___________